00000000000000000000000000000000
00000000000000000000000000000000
00000000000000000000000000000000
00020000000000000000000000000000
00000000000000000000000000000000
00000000000000000000000000000000
00000000000000000000000011101011
00000000000000000000100000000000
00000000000000000001100000000000
00000000011101110011000000000000
00000000110000001100000000000000
00000111000000000000000000000000
00000100000000000000000000000000
00000100000000000000300000000000
00000100000000000000000000000000
00000010000000000000000000000000
00000010000000000000000000000000
00000000000000000000000000000000
